%%%%%%%%%
% .     %
%       %
%%..G%%%%
%       %
%       %
%      P%
%%%%%%%%%
