%%%%%%
%.P. %
% %.%%
%   G% 
%%%%%%
