%%%%%%%%%
%       %
%       %
%%  G   %
%    .  %
%     . %
%   P   %
%%%%%%%%%